11111111111111111111111111
1CCCCCCCCCCC11CCCCCCCCCCC1
1C1111C1111C11C1111C1111C1
1C1111C1111C11C1111C1111C1
1C1111C1111C11C1111C1111C1
1CCCCCCCCCCCCCCCCCCCCCCCC1
1C1111C1C11111111C1C1111C1
1CCCCCC1CCCC11CCCC1CCCCCC1
111111C1111C11C1111C111111
111111C1CCCCCCCCCC1C111111
111111C1C11100111C1C111111
1ECCCCCCC1CNNNNC1CCCCCCCE1
111111C1C11100111C1C111111
111111C1CCCCCCCCCC1C111111
111111C1C1C111111C1C111111
1CCCCCCCCCCC11CCCCCCCCCCC1
1C1111C1111C11C1111C1111C1
1CCC11CCCCCCCCCCCCCC11CCC1
111C11C1C11111111C1C11C111
1CCCCCC1CCCC11CCCC1CCCCCC1
1C111111111C11C111111111C1
1CCCCCCCCCCCCPCCCCCCCCCCC1
11111111111111111111111111

